NOT FOR DISTRIBUTION OR RELEASE, DIRECTLY OR INDIRECTLY, TO UNITED STATES NEWS WIRE SERVICES OR FOR DISSEMINATION IN OR INTO THE UNITED STATES, AUSTRALIA, CANADA, JAPAN, HONG KONG OR SOUTH AFRICA, OR ANY OTHER JURISDICTION IN WHICH THE DISTRIBUTION OR RELEASE WOULD BE UNLAWFUL, EXCEPT AS PERMITTED UNDER APPLICABLE SECURITIES LAW.

Det vert synt til børsmelding 25. november 2019 vedrørande vellukka gjennomføring av Reparasjonsemisjonen i Voss Veksel- og Landmandsbank ASA. Fylgjande primærinnsidarar inklusive nærståande har fått tildeling i emisjonen: 

Namn på 	      Stilling/  Tildeling i Reparasjonsemisjonen   Behaldning etter
primærinnsidar          Verv     inkl. nærståande         tildeling inkl. nærståande

Stig Gunnar Røthe	Administrerande banksjef 2500                          	8040
Stein Kvarekvål  	Styreleiar        	 500                          	1600
Ringheim Invest AS	Eigd av 1. vara styremedlem
                        Nils T. Ringheim	 3205                          	7105
Olav Seim	        Styremedlem	         124                           	1564
Bård Gjerde	        Økonomisjef	         750	                        5567
Sigfrid Nornes Gjerde	Nærståande til økonomisjef
                        Bård Gjerde	         750	                        5567
Kristina Gjerde	        Nærståande til økonomisjef
                        Bård Gjerde	         750                           	5567
Norvald Fretheim	Senior kunderådgjevar	 80	                        320
Liv Sekse	        Kunderådgjevar	         262	                        2242
Lars Istad	        Nærståande til
                        kunderådgjevar Liv Sekse 262	                        2242
Nils-Bjarne Gregersen	Hovudkasserar	         50	                        530
Irene Kvarme	        Kunderådgjevar	         150	                        890
Knut Stein Ure	        Nærståande til
                     kunderådgjevar Irene Kvarme 150	                        890
Johanna R. Sølvberg	Kunderådgjevar	         50	                        150
Britt A. Øverland	Kunderådgjevar	         409	                        809
Ståle Øverland	        Nærståande til
                kunderådgjevar Britt A. Øverland 409	                        809
Øystein Bauge	        Controller/kredittsjef	 130	                        1050
Aud Grete Ekestad	Nærståande til
            controller/kredittsjef Øystein Bauge 130                          	1050
Maritha Hefte	        Kunderådgjevar	         231	                        571
Terje Rokne	        Nærståande til
                    kunderådgjevar Maritha Hefte 231	                        571
May-Kristin V. Dahl	Kunderådgjevar	         38	                        38
Fredrik Jordal Andersen	Nærståande til
              kunderådgjevar May-Kristin V. Dahl 38                             38
Guro Stavenes	        Kunderådgjevar	         16	                        16
Solfrid Dagestad Midttun Leiar privatmarknad	 50	                        70
Eli Mokleiv	        Leiar bedriftsmarknad	 120	                        591
Jakob Håheim	        Nærståande til leiar
                     bedriftsmarknad Eli Mokleiv 120                            591
Reidun Slettemark	Depotansvarleg	         160	                        584
Arvid Birkeland	        Nærståande til
                depotansvarleg Reidun Slettemark 160  	                        584
Jens Håkon Birkeland	Nærståande til
                depotansvarleg Reidun Slettemark 160	                        584
Maria Birkeland	        Nærståande til
                depotansvarleg Reidun Slettemark 160	                        584
Jon Sindre Rødland	Leiar kundeservice	 15	                        16
Mikael Gunder Hellesø	Kunderådgjevar	         13	                        13

Norne Securities AS er tilretteleggjar for Reparasjonsemisjonen og Advokatfirmaet Selmer AS er engasjert som juridisk rådgjevar.

For ytterlegare informasjon kontakt:
Adm. banksjef Stig Gunnar Røthe, tel: 93 03 09 45, e-post: sgr@vekselbanken.no

Opplysningane i denne meldinga er informasjonspliktig etter verdipapirhandellova § 5-12.